"filename", "language", "Markdown", "XML", "Lua", "comment", "blank", "total"
"c:\Program Files (x86)\Steam\steamapps\common\Warhammer 40,000 DARKTIDE\mods\Power_DI\Power_DI.mod", "XML", 0, 11, 0, 0, 2, 13
"c:\Program Files (x86)\Steam\steamapps\common\Warhammer 40,000 DARKTIDE\mods\Power_DI\README.md", "Markdown", 109, 0, 0, 0, 16, 125
"c:\Program Files (x86)\Steam\steamapps\common\Warhammer 40,000 DARKTIDE\mods\Power_DI\scripts\mods\Power_DI\Power_DI.lua", "Lua", 0, 0, 118, 18, 14, 150
"c:\Program Files (x86)\Steam\steamapps\common\Warhammer 40,000 DARKTIDE\mods\Power_DI\scripts\mods\Power_DI\Power_DI_data.lua", "Lua", 0, 0, 100, 10, 2, 112
"c:\Program Files (x86)\Steam\steamapps\common\Warhammer 40,000 DARKTIDE\mods\Power_DI\scripts\mods\Power_DI\Power_DI_localization.lua", "Lua", 0, 0, 762, 137, 7, 906
"c:\Program Files (x86)\Steam\steamapps\common\Warhammer 40,000 DARKTIDE\mods\Power_DI\scripts\mods\Power_DI\libraries\md5.lua", "Lua", 0, 0, 347, 17, 63, 427
"c:\Program Files (x86)\Steam\steamapps\common\Warhammer 40,000 DARKTIDE\mods\Power_DI\scripts\mods\Power_DI\modules\api_manager.lua", "Lua", 0, 0, 39, 6, 7, 52
"c:\Program Files (x86)\Steam\steamapps\common\Warhammer 40,000 DARKTIDE\mods\Power_DI\scripts\mods\Power_DI\modules\coroutine_manager.lua", "Lua", 0, 0, 55, 6, 7, 68
"c:\Program Files (x86)\Steam\steamapps\common\Warhammer 40,000 DARKTIDE\mods\Power_DI\scripts\mods\Power_DI\modules\dataset_manager.lua", "Lua", 0, 0, 357, 65, 61, 483
"c:\Program Files (x86)\Steam\steamapps\common\Warhammer 40,000 DARKTIDE\mods\Power_DI\scripts\mods\Power_DI\modules\datasource_manager.lua", "Lua", 0, 0, 91, 9, 22, 122
"c:\Program Files (x86)\Steam\steamapps\common\Warhammer 40,000 DARKTIDE\mods\Power_DI\scripts\mods\Power_DI\modules\lookup_manager.lua", "Lua", 0, 0, 73, 8, 12, 93
"c:\Program Files (x86)\Steam\steamapps\common\Warhammer 40,000 DARKTIDE\mods\Power_DI\scripts\mods\Power_DI\modules\player_manager_DEPRICATED.lua", "Lua", 0, 0, 29, 1, 5, 35
"c:\Program Files (x86)\Steam\steamapps\common\Warhammer 40,000 DARKTIDE\mods\Power_DI\scripts\mods\Power_DI\modules\realtime_generation_manager_DEPRICATED.lua", "Lua", 0, 0, 71, 1, 4, 76
"c:\Program Files (x86)\Steam\steamapps\common\Warhammer 40,000 DARKTIDE\mods\Power_DI\scripts\mods\Power_DI\modules\report_manager.lua", "Lua", 0, 0, 429, 40, 70, 539
"c:\Program Files (x86)\Steam\steamapps\common\Warhammer 40,000 DARKTIDE\mods\Power_DI\scripts\mods\Power_DI\modules\save_manager.lua", "Lua", 0, 0, 239, 17, 30, 286
"c:\Program Files (x86)\Steam\steamapps\common\Warhammer 40,000 DARKTIDE\mods\Power_DI\scripts\mods\Power_DI\modules\session_manager.lua", "Lua", 0, 0, 124, 13, 23, 160
"c:\Program Files (x86)\Steam\steamapps\common\Warhammer 40,000 DARKTIDE\mods\Power_DI\scripts\mods\Power_DI\modules\ui_manager.lua", "Lua", 0, 0, 6979, 77, 572, 7628
"c:\Program Files (x86)\Steam\steamapps\common\Warhammer 40,000 DARKTIDE\mods\Power_DI\scripts\mods\Power_DI\modules\utilities.lua", "Lua", 0, 0, 212, 18, 38, 268
"c:\Program Files (x86)\Steam\steamapps\common\Warhammer 40,000 DARKTIDE\mods\Power_DI\scripts\mods\Power_DI\modules\view_manager_DEPRICATED.lua", "Lua", 0, 0, 305, 1, 43, 349
"c:\Program Files (x86)\Steam\steamapps\common\Warhammer 40,000 DARKTIDE\mods\Power_DI\scripts\mods\Power_DI\templates\custom_lookup_table_templates\buff_to_talent.lua", "Lua", 0, 0, 26, 0, 3, 29
"c:\Program Files (x86)\Steam\steamapps\common\Warhammer 40,000 DARKTIDE\mods\Power_DI\scripts\mods\Power_DI\templates\custom_lookup_table_templates\combat_abilities.lua", "Lua", 0, 0, 53, 1, 0, 54
"c:\Program Files (x86)\Steam\steamapps\common\Warhammer 40,000 DARKTIDE\mods\Power_DI\scripts\mods\Power_DI\templates\custom_lookup_table_templates\damage_categories.lua", "Lua", 0, 0, 86, 1, 6, 93
"c:\Program Files (x86)\Steam\steamapps\common\Warhammer 40,000 DARKTIDE\mods\Power_DI\scripts\mods\Power_DI\templates\custom_lookup_table_templates\index.lua", "Lua", 0, 0, 8, 0, 0, 8
"c:\Program Files (x86)\Steam\steamapps\common\Warhammer 40,000 DARKTIDE\mods\Power_DI\scripts\mods\Power_DI\templates\custom_lookup_table_templates\minion_categories.lua", "Lua", 0, 0, 289, 1, 1, 291
"c:\Program Files (x86)\Steam\steamapps\common\Warhammer 40,000 DARKTIDE\mods\Power_DI\scripts\mods\Power_DI\templates\custom_lookup_table_templates\player_state_categories.lua", "Lua", 0, 0, 29, 0, 2, 31
"c:\Program Files (x86)\Steam\steamapps\common\Warhammer 40,000 DARKTIDE\mods\Power_DI\scripts\mods\Power_DI\templates\dataset_templates.lua", "Lua", 0, 0, 757, 8, 44, 809
"c:\Program Files (x86)\Steam\steamapps\common\Warhammer 40,000 DARKTIDE\mods\Power_DI\scripts\mods\Power_DI\templates\datasource_templates.lua", "Lua", 0, 0, 1336, 3, 185, 1524
"c:\Program Files (x86)\Steam\steamapps\common\Warhammer 40,000 DARKTIDE\mods\Power_DI\scripts\mods\Power_DI\templates\game_lookup_table_templates.lua", "Lua", 0, 0, 12, 1, 3, 16
"c:\Program Files (x86)\Steam\steamapps\common\Warhammer 40,000 DARKTIDE\mods\Power_DI\scripts\mods\Power_DI\templates\lookup_tables_template_DEPRICATED.lua", "Lua", 0, 0, 125, 4, 13, 142
"c:\Program Files (x86)\Steam\steamapps\common\Warhammer 40,000 DARKTIDE\mods\Power_DI\scripts\mods\Power_DI\templates\renderer_templates.lua", "Lua", 0, 0, 57, 0, 12, 69
"c:\Program Files (x86)\Steam\steamapps\common\Warhammer 40,000 DARKTIDE\mods\Power_DI\scripts\mods\Power_DI\templates\report_templates.lua", "Lua", 0, 0, 227, 2, 3, 232
"c:\Program Files (x86)\Steam\steamapps\common\Warhammer 40,000 DARKTIDE\mods\Power_DI\scripts\mods\Power_DI\templates\save_data_template.lua", "Lua", 0, 0, 5, 1, 1, 7
"c:\Program Files (x86)\Steam\steamapps\common\Warhammer 40,000 DARKTIDE\mods\Power_DI\scripts\mods\Power_DI\templates\scenegraph_templates_DEPRICATED.lua", "Lua", 0, 0, 171, 0, 1, 172
"c:\Program Files (x86)\Steam\steamapps\common\Warhammer 40,000 DARKTIDE\mods\Power_DI\scripts\mods\Power_DI\templates\view_templates.lua", "Lua", 0, 0, 30, 6, 1, 37
"c:\Program Files (x86)\Steam\steamapps\common\Warhammer 40,000 DARKTIDE\mods\Power_DI\scripts\mods\Power_DI\templates\widgets\custom_multi_line_text_input.lua", "Lua", 0, 0, 510, 5, 79, 594
"c:\Program Files (x86)\Steam\steamapps\common\Warhammer 40,000 DARKTIDE\mods\Power_DI\scripts\mods\Power_DI\views\pdi_base_view_DEPRICATED.lua", "Lua", 0, 0, 206, 0, 36, 242
"c:\Program Files (x86)\Steam\steamapps\common\Warhammer 40,000 DARKTIDE\mods\Power_DI\scripts\mods\Power_DI\views\pdi_main_view.lua", "Lua", 0, 0, 36, 0, 4, 40
"c:\Program Files (x86)\Steam\steamapps\common\Warhammer 40,000 DARKTIDE\mods\Power_DI\scripts\mods\Power_DI\views\pdi_main_view_DEPRICATED.lua", "Lua", 0, 0, 564, 2, 38, 604
"c:\Program Files (x86)\Steam\steamapps\common\Warhammer 40,000 DARKTIDE\mods\Power_DI\scripts\mods\Power_DI\views\view_elements_DEPRICATED\pdi_base_view_element_DEPRICATED.lua", "Lua", 0, 0, 206, 0, 41, 247
"c:\Program Files (x86)\Steam\steamapps\common\Warhammer 40,000 DARKTIDE\mods\Power_DI\scripts\mods\Power_DI\views\view_elements_DEPRICATED\pdi_edit_view_element_DEPRICATED.lua", "Lua", 0, 0, 2421, 26, 149, 2596
"c:\Program Files (x86)\Steam\steamapps\common\Warhammer 40,000 DARKTIDE\mods\Power_DI\scripts\mods\Power_DI\views\view_elements_DEPRICATED\pdi_main_view_element_DEPRICATED.lua", "Lua", 0, 0, 648, 6, 39, 693
"c:\Program Files (x86)\Steam\steamapps\common\Warhammer 40,000 DARKTIDE\mods\Power_DI\scripts\mods\Power_DI\views\view_elements_DEPRICATED\pdi_pivot_table_view_element_DEPRICATED.lua", "Lua", 0, 0, 1275, 25, 68, 1368
"Total", "-", 109, 11, 19407, 536, 1727, 21790